  ####   ####
###  #####  #
#.#  #@ # $ #
#.#  #  # $ #
#    #  #   #
#           #
#           #
#############
