#######
# .   #
# $@$.#
#. $$ #
#   . #
#######
