######
# .  #
# $$.#
# @$ #
#.$  #
#  . #
######
