#####################################
#        #                          #
#        #                          #
#   #    #      ###############     #
#   #    #      #             #     #
#   #    #      #             #     #
#   #    #         ####### .  #     #
#   #    #      #             #     #
#   #    #      #             #     #
#   #    ######################     #
#   #    #@            #            #
#   #    #             #            #
#   #    #    #        #            #
#  ##    #    #        ########     #
# $ #         #                     #
#   #         #                     #
#####################################
